6 1 0 6 1 6 0 1 1 6 6 6 0 1 6 6 1 6 6 8 0 1 0 0 0 6 1 6 1 0 6 1 1 1 6 1 0 6 6 6 6 0 6 6 0 8 6 0 9 6 0 0 1 0 0 6 1 1 0 5 0 0 6 0 6 2 2 8 2 3 6 3 2 0 2 3 3 0 3 6 1 6 6 6 6 1 6 1 1 0 6 6 0 1 0 1 0 6 6 0
0 0 0 0 1 6 6 0 6 6 6 1 0 0 1 6 1 1 0 1 0 8 1 1 0 0 8 6 6 0 1 6 6 1 6 6 1 6 1 6 0 6 0 6 1 6 6 1 6 1 1 6 0 1 1 1 1 6 0 1 1 1 6 0 2 3 2 2 6 2 3 3 1 2 0 3 3 3 3 0 0 6 1 1 1 6 0 6 6 0 1 6 6 0 0 1 6 5 0 6
1 6 0 6 6 0 1 1 6 6 1 6 6 1 6 6 6 0 0 1 1 6 6 1 0 6 0 6 0 1 6 0 6 6 6 6 1 6 0 6 1 1 1 0 1 6 6 0 1 6 0 0 6 0 1 6 1 1 0 0 1 1 0 1 3 3 3 2 3 3 1 3 2 3 3 3 2 2 2 1 0 0 1 6 6 9 1 6 0 0 6 0 6 1 6 0 0 0 6 6
5 6 6 1 1 1 0 1 1 0 1 0 0 1 1 1 1 1 0 6 1 1 0 6 6 6 1 1 6 0 0 6 6 1 6 0 6 1 0 0 0 6 6 1 6 6 1 1 0 6 6 6 0 0 6 0 6 0 1 0 6 1 6 0 2 2 2 3 3 6 1 1 6 2 3 0 4 3 4 0 6 0 0 6 1 0 1 0 1 0 6 1 6 6 1 1 6 6 0 1
1 6 1 6 1 1 1 0 6 6 0 6 1 6 6 6 6 6 6 0 0 6 0 0 6 0 6 0 6 1 6 6 6 6 1 6 6 1 0 1 1 1 1 0 0 0 0 1 6 1 6 1 0 0 6 0 0 1 1 6 0 1 6 6 3 2 2 3 2 2 2 3 2 3 2 3 4 4 2 0 0 0 1 0 6 1 0 0 1 0 1 0 1 0 6 1 0 0 6 1
0 6 6 6 6 8 6 1 1 0 0 7 6 0 0 6 0 0 6 5 0 6 6 0 1 1 1 6 1 6 1 6 1 6 6 6 0 6 6 0 0 1 6 0 1 0 6 6 1 6 1 6 6 1 6 6 6 6 1 0 6 0 6 0 2 1 3 2 2 3 2 0 3 6 2 3 4 4 3 0 0 6 6 1 0 1 1 0 1 1 1 0 1 6 6 1 1 1 1 6
6 0 1 6 6 1 1 1 1 0 0 0 0 1 6 0 0 0 6 1 1 6 6 6 0 6 0 6 1 0 6 6 0 1 0 0 0 0 9 1 1 0 6 6 0 0 0 1 1 6 1 0 6 0 1 1 0 1 0 6 1 1 0 6 2 3 2 6 6 8 3 3 2 3 3 1 2 1 3 0 1 1 0 0 1 1 6 0 6 6 1 6 1 6 1 6 0 6 6 0
6 1 1 0 0 1 6 6 1 0 0 6 1 1 0 1 0 0 6 1 0 6 0 6 0 6 0 1 0 6 0 6 1 1 6 1 0 6 0 6 1 0 6 0 0 1 0 6 6 6 0 6 9 0 0 6 1 0 6 6 6 1 6 0 3 3 0 6 2 0 2 2 0 2 3 3 3 1 2 6 1 6 6 0 1 6 5 1 6 6 0 1 1 0 6 0 6 6 1 6
0 6 1 1 6 1 6 6 1 1 1 6 6 6 6 6 0 6 0 0 0 0 6 0 1 0 0 0 1 6 6 1 0 6 6 0 6 1 1 6 6 6 0 1 6 1 6 6 1 0 1 0 0 0 6 0 0 6 6 0 6 1 6 6 6 3 2 1 2 0 0 3 3 1 3 3 3 0 2 0 6 6 1 6 1 6 1 1 1 0 6 6 6 0 0 1 1 6 0 1
0 6 6 6 0 6 0 8 6 1 1 1 0 6 0 6 1 6 6 6 6 1 6 0 1 0 0 6 6 1 0 6 0 6 0 6 6 1 1 6 1 6 0 1 1 1 6 6 6 6 0 6 0 1 1 6 0 1 6 0 6 6 0 6 2 2 6 3 8 3 1 2 3 1 1 2 1 3 6 7 0 7 1 6 6 6 0 6 0 6 0 0 1 6 1 6 8 6 0 0
1 6 1 6 0 6 6 6 6 0 9 0 0 6 6 1 0 0 1 0 0 1 0 0 6 6 0 6 1 1 0 1 6 1 0 6 6 1 0 6 1 1 6 0 1 1 0 6 0 6 1 6 6 0 0 0 6 6 1 0 1 6 1 6 3 3 3 3 3 6 3 2 3 3 3 3 3 3 1 1 0 6 0 1 6 6 1 1 6 1 1 0 6 6 6 0 1 6 0 6
1 6 0 6 6 6 6 0 0 1 6 0 6 6 6 0 0 0 6 6 1 6 6 1 0 0 1 1 1 1 0 6 0 6 1 0 1 1 1 9 6 1 6 1 6 1 1 9 0 0 6 1 1 6 1 0 1 0 6 1 1 1 0 6 3 3 2 7 2 2 2 3 3 3 3 6 2 2 3 0 1 1 1 0 1 0 6 0 0 1 1 1 0 1 6 1 0 1 6 1
6 0 1 6 6 6 1 1 0 1 0 1 1 0 6 1 6 1 6 0 0 0 6 0 1 6 0 6 0 1 6 1 6 1 1 6 1 0 5 1 1 0 0 6 6 6 1 6 1 6 6 0 0 1 0 6 6 6 1 6 0 1 6 0 3 3 3 2 3 3 2 1 3 2 3 3 6 1 3 6 5 6 6 1 0 1 6 0 6 6 0 6 6 6 0 7 6 0 0 6
6 6 0 1 0 1 0 6 6 6 0 0 6 6 6 1 6 0 6 1 6 0 0 6 1 6 0 1 6 0 1 6 0 6 0 6 3 3 3 2 3 1 1 1 2 3 2 3 3 2 2 1 6 0 6 6 6 6 1 9 6 1 6 1 2 3 3 1 3 3 3 3 3 3 2 1 3 2 3 0 0 0 6 6 6 0 1 1 6 6 0 0 6 0 0 6 6 0 1 1
6 6 1 1 6 1 6 6 0 6 6 0 1 0 0 0 1 1 6 6 6 1 1 6 6 6 1 0 6 1 0 0 7 1 6 0 3 2 2 2 2 0 2 2 6 3 2 1 6 0 3 6 6 1 0 1 6 6 0 1 6 6 8 1 0 2 3 3 2 3 2 6 2 3 3 2 3 3 1 0 0 6 6 1 6 6 1 0 1 6 6 1 0 0 6 0 0 0 1 6
6 6 0 0 6 0 1 6 6 6 0 1 0 1 1 0 6 6 1 6 0 6 0 6 0 6 0 6 0 4 4 4 1 0 6 1 6 3 2 3 2 3 3 2 1 2 2 3 3 2 2 6 0 1 1 6 1 6 0 0 1 0 1 0 1 1 0 6 6 6 0 6 6 0 0 1 6 6 6 6 6 0 6 0 6 0 6 6 0 0 1 0 6 6 6 6 6 0 6 0
0 6 1 0 0 6 6 0 6 1 1 0 0 1 6 6 6 0 6 1 6 0 6 1 1 6 1 0 1 8 0 4 6 6 6 6 3 2 2 3 2 3 2 6 3 0 2 3 1 3 3 0 6 6 0 0 6 1 1 6 1 1 1 6 6 6 0 1 0 1 0 0 1 6 0 6 1 6 0 6 6 6 0 6 0 0 1 0 6 6 6 0 6 1 1 1 6 0 6 6
0 0 6 0 6 1 0 0 6 1 1 6 1 1 6 0 6 1 0 6 1 6 1 0 6 6 6 6 1 4 6 1 1 0 6 0 2 3 3 2 3 3 1 3 2 3 6 1 3 3 7 0 0 6 0 6 6 1 1 6 0 6 6 6 1 1 0 6 6 6 6 6 6 1 0 6 1 0 0 0 6 1 1 1 6 6 0 0 1 1 0 0 6 6 0 1 6 1 1 6
6 1 1 0 6 1 6 6 0 1 1 6 1 6 1 1 0 6 6 1 6 1 0 6 1 6 1 6 0 6 6 6 1 8 1 6 3 6 1 2 0 2 0 2 3 0 3 2 3 3 2 1 1 0 1 6 6 1 6 0 6 1 0 1 1 5 1 0 1 1 1 0 0 1 0 6 0 6 6 8 0 6 1 6 1 1 6 0 6 0 6 1 0 6 6 1 6 0 0 6
0 6 0 1 0 6 0 6 0 1 1 0 1 0 0 0 0 6 0 8 1 6 1 1 0 6 1 0 1 6 1 6 1 6 6 0 3 6 3 2 3 3 3 6 2 2 3 3 3 0 1 6 1 7 0 6 6 0 1 1 6 6 6 6 0 6 6 1 6 1 0 6 6 0 6 6 0 0 6 1 1 6 6 1 0 6 6 0 6 6 6 0 0 6 0 6 6 1 0 6
1 0 6 0 0 6 1 6 6 1 0 0 6 0 6 1 6 0 0 6 0 6 0 1 0 1 1 0 6 1 1 6 1 6 0 6 2 3 6 2 3 3 6 3 3 0 6 2 2 3 2 0 1 1 1 6 6 6 1 6 1 0 6 1 0 6 0 1 0 0 0 1 9 1 6 0 6 6 6 6 6 1 6 0 6 1 0 6 6 6 6 6 0 0 1 0 6 1 0 6
6 6 0 7 6 6 1 0 1 1 0 6 6 1 1 0 1 1 1 1 1 1 0 0 6 6 1 1 1 1 6 1 1 1 0 7 2 6 3 6 0 2 2 2 1 2 2 2 2 2 3 0 6 6 6 1 1 6 9 6 0 6 6 6 1 6 6 1 0 6 6 1 6 6 7 0 6 6 0 1 1 6 0 0 1 1 0 6 1 6 0 1 6 0 6 5 1 6 0 1
6 6 5 0 1 0 0 1 6 0 1 6 1 6 1 1 6 6 6 1 0 6 1 1 6 1 6 0 1 6 1 1 1 6 0 6 3 1 3 2 2 3 0 2 3 3 2 0 3 2 3 6 1 0 6 0 0 1 1 1 1 6 1 0 1 8 0 6 1 1 0 0 0 6 6 6 6 0 1 6 6 1 1 6 0 0 0 6 6 1 1 6 1 1 6 0 6 6 1 1
6 0 1 0 1 6 4 0 4 6 6 0 0 0 1 0 1 1 6 5 0 0 1 6 6 6 6 0 0 0 0 6 0 0 6 6 3 2 3 6 3 0 2 6 2 6 6 3 3 3 2 1 0 1 1 6 1 1 9 1 0 0 0 1 6 6 6 1 0 6 0 6 6 6 6 1 0 1 0 1 6 6 0 0 6 6 0 6 1 1 0 0 6 6 6 6 6 5 6 6
1 0 6 6 0 1 4 5 1 1 6 8 1 0 0 0 1 0 6 0 0 0 0 6 0 1 6 1 1 1 1 6 6 0 1 1 2 6 2 3 3 0 3 2 2 3 0 1 3 2 3 0 1 0 1 6 0 6 6 1 1 0 0 1 1 6 1 0 0 1 0 1 1 6 0 8 1 5 6 6 6 1 0 6 6 0 5 1 6 6 0 1 0 6 1 0 0 1 0 6
0 0 1 0 0 6 4 6 4 1 1 1 5 6 6 1 6 6 6 1 0 6 1 1 1 6 1 0 6 6 0 0 1 1 0 0 0 3 3 2 2 3 3 3 2 2 2 3 1 7 2 1 1 6 6 6 0 1 0 0 1 6 6 1 6 1 6 6 6 1 0 0 0 0 0 6 6 6 5 6 1 1 9 6 1 6 0 6 6 0 1 0 6 6 6 1 6 1 6 6
0 6 6 6 6 6 1 6 1 1 1 0 1 6 0 0 1 6 6 1 1 0 0 0 1 1 6 6 0 0 1 6 6 0 6 0 2 3 2 3 3 3 0 3 2 2 2 3 3 3 3 6 6 0 1 1 1 6 0 0 6 6 1 0 6 1 0 6 0 1 6 6 6 1 6 0 1 0 6 1 1 0 0 6 1 6 0 6 0 6 0 0 0 1 6 0 0 1 6 0
6 6 6 1 1 1 1 6 6 1 1 1 1 6 6 1 6 0 6 6 0 9 1 6 6 1 1 0 6 6 0 0 1 6 0 6 2 2 2 3 3 2 2 2 3 2 2 3 3 2 3 1 0 0 1 6 6 6 0 1 0 6 0 6 1 6 1 1 1 1 1 1 6 0 6 0 0 6 0 0 6 6 0 1 1 1 1 6 6 6 0 1 1 1 6 6 0 1 1 0
6 6 0 0 6 1 0 6 6 0 0 0 6 1 0 6 1 0 0 6 0 1 6 1 0 1 0 0 8 6 0 0 0 6 6 0 0 0 0 1 0 6 1 6 6 6 1 0 1 0 6 6 1 6 6 0 6 6 6 6 0 0 6 0 6 9 6 0 6 6 1 6 6 0 0 6 0 6 1 6 1 1 1 0 1 1 6 1 1 0 1 6 6 9 0 0 1 6 0 6
1 6 6 6 6 1 0 1 6 0 6 1 6 6 0 6 1 1 1 1 0 6 6 0 6 1 6 6 6 1 1 1 1 0 6 1 1 1 6 6 0 0 1 6 6 0 1 6 0 1 1 0 0 6 0 0 1 6 6 6 6 6 6 6 0 1 6 0 1 0 1 0 0 1 6 0 6 1 1 6 0 6 6 1 0 0 7 6 1 1 0 6 1 6 6 1 6 0 1 1
6 6 1 0 6 6 1 6 6 1 6 6 6 1 6 0 6 1 6 0 6 6 6 6 0 1 1 1 0 0 1 1 6 6 1 1 6 1 0 1 0 0 6 1 0 0 1 1 0 1 6 1 6 0 6 6 1 1 0 6 1 0 6 7 0 0 1 6 0 1 9 6 1 6 1 6 6 1 6 0 6 0 1 1 1 6 0 6 1 1 0 1 1 1 0 6 0 1 6 0
0 1 6 6 1 0 1 0 6 1 1 0 1 0 6 6 6 6 0 6 0 0 1 1 1 6 0 0 6 7 6 2 2 2 3 3 3 3 9 2 2 7 3 3 6 1 0 6 6 0 1 6 6 6 6 1 6 0 1 1 6 6 1 0 0 1 1 0 6 1 6 6 6 6 0 6 6 0 1 6 0 6 0 6 0 1 1 6 6 0 0 6 0 1 1 0 1 6 6 0
6 1 0 6 0 6 1 1 0 0 6 6 0 6 0 0 6 6 6 6 1 0 6 1 0 1 1 6 6 6 2 2 3 6 2 2 2 3 1 2 6 3 3 2 2 6 6 6 0 6 1 6 0 6 6 1 0 6 0 0 0 6 0 0 0 0 1 6 6 6 1 6 0 1 6 6 6 6 0 0 1 6 6 6 0 1 8 6 0 0 0 6 6 0 1 6 6 1 0 1
6 1 0 1 6 1 6 6 0 0 6 1 6 6 1 6 6 1 6 6 6 1 1 0 1 0 0 1 6 6 2 2 3 3 6 3 3 2 2 3 2 2 2 2 6 6 6 6 8 6 0 1 6 6 0 6 6 6 6 1 6 6 0 6 6 1 1 1 1 1 6 1 1 6 0 0 1 6 1 6 6 0 1 6 6 1 6 6 6 1 0 6 0 0 1 6 0 0 7 0
0 1 0 1 6 6 1 1 0 1 6 6 0 1 1 6 0 1 0 6 0 0 6 0 1 6 6 6 1 1 2 3 3 3 2 2 3 2 3 3 2 3 3 3 2 6 1 1 6 1 6 6 0 0 6 1 6 1 0 6 1 6 6 6 1 1 0 1 6 1 6 6 1 0 1 1 1 6 1 1 1 6 0 6 1 6 1 1 6 0 1 0 1 0 6 6 6 0 1 6
0 6 0 6 1 0 1 0 0 0 9 0 6 1 0 6 0 1 6 0 0 0 6 1 0 1 1 6 1 6 2 9 3 2 6 3 2 0 3 5 3 3 3 5 2 6 6 7 0 1 1 0 0 6 1 6 6 6 1 6 6 0 0 0 1 1 0 6 0 1 0 1 1 6 0 1 1 0 0 0 0 0 1 0 1 1 0 6 6 1 1 6 1 6 1 6 6 1 0 0
0 1 0 0 6 6 6 0 1 1 1 6 0 0 1 9 6 6 1 6 6 6 1 6 6 0 0 1 6 0 2 3 0 3 6 3 3 6 6 0 2 3 2 3 3 6 5 1 1 6 6 1 0 0 6 0 6 0 0 0 0 5 0 0 1 6 0 0 1 0 1 0 6 0 0 6 0 6 6 1 1 6 1 1 1 0 6 1 1 6 6 6 1 0 0 6 6 1 0 1
6 0 0 0 1 1 0 6 6 9 0 6 0 6 6 0 0 1 1 0 6 1 1 0 6 0 6 0 0 0 2 3 6 6 6 6 2 3 3 1 1 2 2 3 3 0 1 0 6 6 6 0 6 6 1 6 6 0 0 6 6 6 1 0 6 6 1 0 1 0 1 5 0 6 0 1 0 6 6 1 6 0 6 0 1 0 6 0 6 6 0 6 1 6 1 0 6 0 0 0
6 8 6 0 1 1 6 6 8 1 6 0 1 1 0 6 1 6 0 6 0 6 1 0 6 6 1 6 6 0 3 6 6 6 3 2 0 2 3 2 3 3 3 3 3 6 0 1 0 6 0 6 0 1 1 1 0 6 6 0 6 6 1 0 1 0 6 6 6 6 1 6 1 6 6 0 1 6 6 6 0 6 6 0 0 0 0 6 1 1 8 0 6 6 6 0 1 1 6 6
6 1 1 0 1 6 0 1 6 0 1 6 6 1 6 6 9 6 1 1 6 0 0 1 1 6 0 1 6 6 2 7 2 3 1 2 2 3 0 3 2 3 3 3 3 6 1 6 0 6 6 1 0 6 0 6 0 6 1 1 0 1 1 0 6 0 0 6 0 6 0 6 6 1 1 5 6 1 6 0 6 1 6 1 0 1 0 1 6 0 6 6 7 6 1 1 8 6 1 6
0 6 0 1 1 1 1 0 0 1 1 1 1 6 6 0 6 1 1 6 0 0 6 1 6 0 0 6 6 1 2 2 0 2 2 2 1 2 2 2 3 1 3 2 3 6 1 0 0 1 6 1 1 0 0 6 1 6 6 0 6 6 1 6 0 1 0 6 1 0 0 0 1 0 0 6 1 6 0 0 0 1 6 1 6 1 1 6 6 1 0 6 6 0 1 6 0 6 0 6
6 1 0 1 6 6 6 1 1 0 0 0 0 0 1 0 1 0 1 1 0 6 0 1 0 1 0 6 1 0 2 3 3 3 1 3 3 2 2 3 2 3 1 2 2 0 6 1 7 0 0 1 1 6 6 1 6 0 0 1 0 0 6 6 1 1 0 1 1 0 6 1 1 0 0 6 1 8 0 6 6 6 6 1 0 0 6 1 0 1 1 1 6 1 1 0 1 6 6 6
6 6 6 0 0 1 1 0 0 0 0 0 6 6 1 6 1 1 1 1 0 6 6 0 0 9 1 0 1 6 2 1 0 2 6 3 2 3 3 6 2 3 2 2 0 0 5 0 1 0 0 6 1 1 6 6 1 6 6 6 6 1 0 0 6 6 6 6 6 4 4 9 1 0 6 4 4 6 6 6 0 6 0 6 1 6 1 6 1 6 0 0 6 1 9 0 1 6 1 6
1 0 0 0 0 6 0 6 6 1 1 1 1 6 1 1 6 6 0 0 6 6 0 1 6 6 6 6 6 6 2 6 3 7 3 3 3 2 3 3 2 2 2 2 0 6 1 6 0 0 6 0 6 0 7 6 6 6 0 0 1 6 6 6 1 0 6 6 6 4 4 4 0 6 4 6 4 1 0 1 6 6 6 0 1 0 0 0 6 6 6 0 0 6 6 0 0 5 1 0
6 1 6 6 1 6 6 0 6 0 1 0 6 6 6 0 0 6 0 1 1 0 0 0 8 1 6 6 0 6 3 0 2 2 2 0 2 0 2 0 2 2 1 6 6 1 6 6 0 6 1 0 0 6 0 1 0 1 1 6 6 6 1 0 6 0 0 0 6 7 4 4 0 6 6 9 4 3 3 1 0 5 3 3 6 6 5 3 2 3 0 0 6 6 6 1 6 6 0 0
0 0 6 1 1 1 1 0 0 6 8 6 1 0 6 0 6 6 1 1 6 0 1 0 6 6 6 1 6 0 3 2 3 2 2 3 7 2 1 3 3 2 2 1 0 6 1 6 1 6 0 0 1 1 6 1 1 0 0 0 6 0 6 0 1 1 0 0 7 6 6 1 0 1 6 2 2 2 3 1 2 2 3 1 3 1 3 2 3 2 6 1 1 6 6 6 6 6 1 1
0 6 1 1 6 1 6 6 1 6 0 1 6 1 6 1 6 1 6 6 6 1 6 0 6 0 6 1 6 0 6 0 6 0 6 1 0 6 6 1 1 1 1 1 6 6 1 0 0 6 1 1 0 1 1 0 0 0 0 0 6 1 0 1 1 1 0 1 6 1 6 6 6 0 1 2 3 2 1 3 2 3 1 3 2 3 2 2 3 9 6 6 0 6 0 0 0 6 8 1
0 6 1 6 1 1 6 1 6 6 1 1 6 0 6 1 9 1 6 0 6 6 0 6 1 0 0 1 6 1 0 6 1 6 6 6 1 1 6 1 0 0 1 6 6 6 0 1 1 1 6 6 1 6 6 1 0 6 6 1 0 6 1 0 6 6 5 6 6 0 1 0 1 6 6 1 3 3 2 2 2 3 3 3 2 3 3 2 2 3 0 6 6 0 0 1 6 0 0 6
6 0 1 6 6 0 1 0 6 6 1 6 7 6 6 1 1 0 6 6 0 6 0 0 1 1 0 6 6 0 1 1 1 1 0 6 0 0 1 1 6 6 6 0 1 6 6 1 6 6 0 0 6 6 6 0 0 0 1 6 1 6 0 6 1 1 0 6 1 1 0 6 1 0 6 2 3 2 2 2 3 2 6 2 3 6 3 3 2 3 6 1 9 6 1 6 1 6 0 1
1 6 6 0 6 1 0 6 6 6 0 6 6 0 0 6 6 1 0 6 1 6 6 1 6 6 1 1 1 6 6 0 0 0 6 0 1 6 0 1 0 0 1 0 6 6 0 6 6 6 6 6 0 0 0 6 1 6 6 6 6 0 6 6 1 0 6 0 6 0 6 1 0 1 6 2 3 2 2 3 2 2 2 3 2 3 2 2 3 3 0 0 6 6 6 1 6 6 6 6
1 1 1 6 6 1 0 6 1 6 6 6 0 0 0 0 6 1 6 1 1 6 6 0 6 0 6 0 6 6 0 0 6 1 6 6 0 6 0 6 1 1 6 6 1 1 6 6 0 1 1 6 6 6 0 1 0 6 0 6 6 0 6 0 0 6 1 0 1 0 1 0 1 6 0 3 3 2 6 3 2 2 2 3 2 0 2 3 3 2 6 0 6 6 0 6 6 1 0 6
6 0 1 1 1 1 1 1 6 6 6 1 1 9 1 6 6 1 6 0 6 0 6 6 6 8 0 6 0 1 6 1 6 6 0 0 1 6 0 0 6 0 0 0 6 0 8 0 6 1 0 0 6 6 6 1 1 1 6 1 1 0 6 6 1 1 6 0 6 0 6 6 0 6 0 3 2 2 2 1 2 2 3 2 3 3 3 2 3 2 0 0 6 0 6 0 0 1 0 0
1 1 6 0 6 0 9 1 6 0 0 1 1 6 1 6 1 9 6 1 1 6 0 1 1 6 6 0 1 0 6 1 0 6 6 8 1 1 1 6 1 6 6 6 6 6 0 6 6 6 0 6 0 6 0 1 1 0 0 6 1 0 6 1 6 6 1 0 6 1 6 1 6 6 0 2 0 2 1 2 2 3 3 2 1 6 2 6 3 2 1 0 0 6 6 0 0 1 6 1
0 1 6 6 0 1 1 6 6 1 1 6 0 6 1 1 1 1 6 6 6 6 1 1 6 6 6 6 6 1 0 6 1 1 6 6 6 1 0 1 6 1 6 0 6 0 6 1 0 1 1 1 0 0 0 0 1 0 1 0 6 0 6 1 6 6 1 1 1 6 6 6 6 1 0 2 9 3 2 1 0 0 2 3 7 0 6 3 3 6 0 6 6 1 0 0 1 6 1 0
0 1 6 6 0 6 6 6 6 1 0 0 0 6 0 1 0 0 0 6 1 0 6 6 6 1 1 6 8 1 6 8 0 6 1 1 1 6 1 6 0 1 1 0 0 0 1 1 1 6 6 0 0 6 0 1 6 6 6 1 6 6 0 0 0 6 6 0 0 6 1 1 6 0 6 2 2 2 3 2 1 6 2 3 2 1 3 2 2 3 6 0 0 6 0 6 6 0 1 1
0 1 1 6 6 0 1 1 6 0 1 1 6 6 1 1 0 1 6 6 0 6 1 5 6 0 1 6 1 0 1 8 0 0 1 0 6 6 6 6 1 0 0 0 1 0 1 0 0 1 0 6 6 1 0 1 6 6 6 0 0 0 6 0 6 6 1 6 0 0 6 1 6 6 6 2 1 0 3 2 3 2 2 6 6 2 3 3 2 0 6 6 6 0 6 1 0 0 7 1
0 6 6 6 0 6 6 1 6 1 0 6 6 1 6 6 6 0 6 0 1 1 0 1 7 1 0 1 6 6 0 1 1 1 6 0 6 0 1 6 6 1 1 0 6 1 6 6 6 9 1 1 6 6 6 0 6 6 1 0 6 1 6 1 1 6 0 6 6 1 1 6 0 6 0 2 3 6 0 2 2 2 3 3 0 3 3 3 3 3 1 0 6 1 0 6 0 0 1 6
0 0 0 1 0 1 0 1 6 6 0 6 7 0 6 1 0 6 1 6 1 7 1 6 1 6 6 1 0 1 0 6 0 1 0 6 1 1 0 1 6 0 0 6 6 6 1 1 6 1 0 1 1 6 6 1 6 0 6 1 1 6 1 1 1 0 6 6 1 6 6 0 0 1 0 2 3 3 3 2 2 2 3 2 3 2 2 3 3 1 0 0 1 7 6 0 1 6 1 1
6 1 1 1 0 6 6 6 1 6 6 1 1 1 1 1 6 0 1 6 1 0 0 6 0 6 6 6 0 1 0 9 0 1 1 0 0 6 0 1 6 1 1 6 1 6 1 0 0 6 6 1 6 6 6 6 1 1 0 1 0 1 6 0 1 6 0 6 6 1 1 1 1 6 6 9 3 3 2 3 3 3 2 3 6 2 3 3 0 0 1 0 1 6 1 0 6 6 6 1
6 0 0 0 0 6 6 6 1 6 1 1 0 0 1 0 6 0 6 6 0 0 0 6 0 6 6 1 1 0 0 0 5 6 6 1 1 1 6 0 6 6 0 6 0 6 1 6 6 0 1 6 0 1 0 0 0 1 1 1 1 1 6 1 6 1 0 6 6 7 6 6 6 0 0 1 6 6 0 0 0 6 6 6 1 1 0 6 0 6 1 1 0 6 6 1 0 6 6 6
1 1 1 6 1 6 6 1 6 1 6 6 1 0 6 6 0 6 6 6 6 0 0 6 6 6 6 6 0 1 1 1 6 6 6 0 0 6 6 6 6 0 0 0 0 1 6 6 6 6 6 8 1 0 1 6 0 0 1 6 1 0 1 0 0 6 6 0 6 6 0 0 1 6 6 0 1 1 6 6 1 1 1 0 1 0 0 0 0 6 0 1 0 1 5 8 0 1 1 0
1 1 1 6 6 0 1 0 6 6 0 1 1 1 5 0 6 6 6 6 0 1 0 0 0 1 6 6 6 6 6 1 1 6 6 6 6 6 6 5 1 6 0 6 1 6 1 0 1 0 6 6 6 6 1 9 6 0 1 6 6 1 6 0 1 6 6 0 6 0 1 6 6 6 1 6 0 6 6 6 1 1 0 0 0 6 0 0 6 0 6 1 1 1 6 1 1 6 1 6
6 0 1 6 6 6 1 6 6 0 1 6 0 0 9 6 6 0 6 6 6 1 1 6 6 0 1 1 0 1 1 1 6 0 0 1 6 6 0 1 0 6 0 6 6 1 1 0 6 6 1 6 6 6 1 6 6 6 1 6 0 6 1 1 6 0 6 1 0 0 6 1 6 6 6 1 6 0 6 1 6 0 0 1 6 1 0 6 6 0 6 6 8 0 1 6 0 6 1 1
6 6 0 0 6 1 1 1 6 0 6 6 6 6 6 6 1 6 6 6 7 6 0 6 1 1 0 6 0 0 6 6 1 6 6 1 6 0 6 0 6 6 6 6 1 9 6 0 0 0 0 6 6 0 6 0 0 0 6 0 1 1 0 6 1 6 1 0 6 7 0 1 1 0 0 1 1 6 0 6 1 0 0 0 6 0 6 6 0 0 0 6 6 1 0 0 0 6 0 6
6 1 0 6 6 6 5 6 1 1 1 1 6 1 1 1 0 9 6 0 6 1 0 0 1 0 6 0 6 1 6 1 1 1 6 1 9 6 1 0 0 0 0 6 6 0 6 0 0 6 6 1 6 1 1 6 1 1 0 0 0 6 1 6 6 6 0 6 1 0 6 1 0 6 6 6 6 6 0 4 4 6 0 6 1 6 6 6 0 6 6 1 0 7 6 6 1 6 6 9
6 0 0 0 0 1 0 0 0 7 0 6 1 6 1 0 6 6 6 0 1 0 0 1 6 6 0 6 1 6 6 6 1 0 6 1 6 1 6 6 6 0 1 1 0 6 0 0 6 0 6 1 6 1 0 6 1 1 6 1 6 6 0 6 1 0 6 6 6 6 6 6 7 0 1 0 6 6 4 4 4 1 6 0 6 6 0 6 6 0 0 6 1 6 6 6 6 6 1 6
0 1 1 6 0 0 1 1 1 0 6 0 6 1 6 0 6 0 7 6 1 6 6 6 1 0 6 1 0 6 1 1 1 0 1 1 1 6 1 6 6 6 1 1 1 1 1 0 6 1 1 6 8 0 1 6 1 1 1 1 0 1 1 0 0 6 1 0 6 0 0 1 6 1 0 6 6 6 4 4 4 1 0 0 1 0 1 1 1 0 1 6 6 0 0 9 1 6 0 1
6 6 1 6 6 1 6 1 6 6 6 1 0 0 1 6 6 1 1 1 6 0 1 1 1 9 6 0 1 1 1 6 1 6 0 0 6 6 1 1 7 6 1 6 6 6 6 0 1 0 0 1 6 6 6 6 6 6 0 0 0 0 1 1 0 7 0 1 0 0 1 0 6 0 6 6 0 1 6 0 0 0 8 0 0 6 6 6 0 1 6 1 6 6 0 0 0 1 6 6
0 0 1 1 6 6 1 1 6 0 6 0 1 6 6 1 1 1 0 0 0 6 1 6 0 1 6 1 6 1 6 6 6 1 1 0 6 0 0 0 0 6 1 1 0 6 6 6 6 6 0 6 6 1 0 1 1 6 6 6 1 0 1 6 1 6 1 0 6 6 1 0 6 1 7 0 0 6 6 6 6 6 6 1 0 1 6 6 6 1 0 6 0 1 0 6 6 6 0 6
1 0 6 6 1 6 1 1 6 1 6 0 0 0 1 1 1 1 6 0 1 0 1 0 0 6 1 6 0 0 6 6 6 1 6 6 1 0 6 0 6 1 6 6 0 6 6 6 1 1 0 6 1 6 0 6 6 1 0 8 1 1 6 1 0 6 6 1 0 6 0 0 1 6 1 1 1 1 6 1 1 1 0 1 0 6 1 6 0 6 0 6 1 1 6 0 6 6 6 1
6 1 6 1 6 8 0 1 0 1 1 0 1 0 0 1 0 6 0 0 6 0 1 1 6 6 1 0 1 6 6 1 6 0 0 6 1 6 6 0 0 6 0 6 6 0 6 0 6 6 1 6 6 6 1 6 6 1 1 1 0 1 0 6 1 6 6 1 6 1 6 1 5 6 1 1 0 1 0 6 6 6 6 1 6 0 6 1 1 6 6 6 1 6 0 1 1 6 6 0
1 6 0 6 1 6 6 6 1 0 0 1 0 0 6 6 0 0 1 0 1 6 0 0 0 6 1 0 6 0 1 1 0 1 0 6 1 6 0 6 6 1 0 1 0 6 1 6 1 6 0 1 0 0 1 1 6 0 1 0 6 6 6 0 0 0 0 6 6 0 6 1 0 0 1 6 7 0 6 6 1 1 1 1 0 0 6 6 0 0 1 0 6 1 8 6 0 6 1 6
0 6 6 6 1 1 6 1 0 0 0 6 6 6 0 1 6 6 1 6 0 0 1 0 0 1 1 0 0 6 0 6 1 0 6 0 0 6 8 1 0 0 0 8 6 6 0 6 0 0 6 1 0 6 6 2 0 3 6 1 0 6 1 3 2 3 0 8 6 3 6 0 6 6 1 6 1 1 1 6 0 6 6 6 0 0 1 6 1 0 7 6 0 6 0 1 6 0 6 8
1 6 6 0 1 0 0 6 7 6 6 6 1 6 6 6 0 6 1 6 1 6 6 6 0 6 0 1 1 6 0 1 0 6 0 0 1 0 6 1 0 0 1 1 6 1 0 6 1 1 0 1 6 6 6 2 3 2 2 6 9 2 3 3 3 2 2 2 1 1 6 6 6 0 6 6 0 6 1 1 0 1 1 1 1 1 0 9 0 0 6 0 1 1 1 7 0 6 1 0
6 0 6 1 6 1 6 1 1 1 8 1 6 1 1 1 8 1 1 6 1 6 6 0 1 1 1 0 6 6 0 6 6 6 0 1 0 6 6 1 0 6 6 0 6 1 1 0 0 1 0 0 0 1 1 6 7 2 0 3 2 3 3 6 3 3 2 3 2 2 6 6 6 0 1 1 1 0 6 1 0 0 1 6 0 0 0 6 0 0 6 6 0 6 6 1 1 0 6 6
1 0 6 6 6 6 6 0 1 0 6 0 6 1 1 6 6 6 0 6 0 1 1 0 0 9 6 0 0 6 1 1 0 6 6 0 0 0 6 6 0 0 0 0 1 0 1 1 6 1 6 0 6 0 6 2 3 1 3 2 2 3 3 2 2 3 3 2 2 2 0 0 6 0 6 0 0 0 6 6 6 0 6 6 6 1 1 0 6 0 0 6 1 6 6 1 1 6 6 6
1 5 1 5 0 0 1 1 1 0 6 6 6 6 0 0 0 1 6 0 6 1 6 1 1 0 1 6 6 6 0 6 6 0 1 1 6 1 0 1 6 0 6 1 7 0 1 0 6 1 5 0 8 0 6 2 3 3 2 3 2 2 3 0 3 3 3 6 1 3 1 8 0 6 6 6 1 1 0 6 6 1 6 6 0 0 6 0 6 1 1 6 6 0 9 6 1 6 1 1
0 1 0 6 6 6 0 6 1 1 6 6 0 0 1 6 6 1 1 6 0 6 0 6 1 1 6 1 1 1 0 1 6 1 6 6 6 0 0 0 8 0 0 1 1 0 0 6 6 1 6 1 6 0 1 3 2 3 2 1 3 2 3 2 3 2 7 2 2 2 1 0 6 1 6 1 1 1 6 0 9 0 6 1 0 1 0 1 6 6 1 1 6 0 6 1 6 0 6 6
1 0 0 0 0 0 1 0 0 1 6 6 1 0 0 6 0 6 6 6 0 1 6 6 6 6 5 0 1 0 7 0 6 1 6 1 0 1 6 0 6 0 0 0 6 1 6 0 1 6 6 6 6 6 1 2 3 3 3 2 3 3 2 6 2 6 3 3 3 2 6 0 6 0 1 6 0 0 0 1 1 8 1 6 6 6 6 6 6 6 1 0 0 1 0 6 0 0 6 6
6 1 0 6 1 0 6 1 6 1 6 6 0 1 0 6 1 0 6 6 1 1 6 1 6 1 0 0 0 6 1 6 1 0 0 6 0 6 0 6 1 5 6 0 1 0 0 6 6 6 0 0 6 1 8 2 0 2 0 2 3 3 3 2 2 2 6 6 2 2 1 1 1 0 0 6 6 6 6 0 0 6 0 0 0 6 6 6 6 1 0 6 0 1 0 6 6 0 9 0
6 1 0 1 6 1 6 0 1 0 0 6 0 6 6 0 6 1 6 1 6 0 1 6 1 1 1 0 1 0 6 6 0 0 1 1 6 6 6 1 1 0 6 0 6 6 1 1 6 0 1 1 1 6 6 3 3 2 2 2 5 3 2 1 2 2 2 1 1 2 6 0 1 1 6 1 6 1 0 0 6 0 1 6 6 6 6 6 0 1 0 6 6 1 6 6 0 0 1 6
0 1 0 0 6 6 1 0 6 6 1 1 0 0 6 6 6 0 0 6 1 0 6 1 6 6 6 0 1 1 6 0 0 0 1 0 1 6 6 1 6 6 0 6 6 1 1 1 1 0 6 0 1 6 0 3 3 2 2 2 2 2 2 2 3 3 3 3 2 2 6 6 1 0 1 0 6 6 1 6 6 6 0 1 0 6 6 1 6 6 6 1 6 7 1 0 6 6 0 1
0 1 1 1 6 6 6 6 6 6 6 0 6 0 1 6 0 0 0 6 6 6 0 6 1 6 6 6 6 0 1 6 6 0 1 0 6 1 6 6 1 6 0 1 6 6 6 0 1 1 1 1 6 6 1 2 3 0 3 2 2 6 2 7 2 2 3 3 2 0 6 6 6 6 0 6 6 0 1 0 1 1 6 8 6 1 1 6 6 6 6 6 1 1 0 0 1 1 6 1
1 6 1 7 1 6 6 6 1 1 0 0 8 6 6 1 1 0 0 6 6 7 0 6 6 0 6 0 1 1 8 1 0 6 6 6 0 7 0 0 6 6 0 4 4 1 6 5 9 6 1 6 1 1 0 3 6 6 3 3 3 7 2 3 3 2 3 2 2 3 0 6 1 0 6 7 6 0 1 1 1 1 0 0 1 6 0 1 1 6 1 9 0 6 0 1 1 1 1 0
6 1 0 6 1 1 6 0 1 1 0 1 9 1 6 1 6 6 1 1 1 6 1 0 1 0 0 0 0 6 1 0 1 1 6 0 1 0 1 5 0 6 1 4 4 4 1 6 6 0 1 0 1 0 1 2 2 3 2 3 2 3 2 3 0 3 2 2 2 3 6 1 6 0 0 6 1 0 0 6 0 6 6 6 0 1 6 0 1 0 6 0 1 0 1 1 6 0 1 0
6 0 6 0 6 0 6 6 0 6 6 6 6 1 6 6 6 6 6 1 6 1 6 8 1 1 6 6 6 0 1 0 0 6 1 6 1 7 6 1 6 1 1 4 1 4 0 0 0 1 1 6 0 0 6 6 3 3 3 2 3 2 2 3 3 2 2 3 6 2 0 1 0 6 6 0 0 0 0 1 6 6 6 1 0 0 6 1 1 1 0 6 1 0 0 6 0 0 0 1
1 6 1 6 6 6 0 6 0 1 0 6 6 9 6 6 0 1 0 6 8 0 1 6 1 1 1 5 1 6 1 6 1 9 6 0 6 6 6 6 6 0 6 0 1 0 1 1 0 6 0 6 1 1 6 3 3 2 2 3 1 3 0 2 3 2 1 3 2 3 6 1 6 1 1 6 0 6 0 6 6 0 6 1 0 0 0 1 0 6 6 1 0 0 0 1 6 0 6 1
0 0 1 6 0 1 0 0 6 6 0 6 0 1 0 6 1 0 6 1 6 6 1 0 0 1 6 0 6 6 0 1 0 1 0 0 0 1 0 1 4 6 6 6 1 1 0 0 6 0 6 0 0 6 1 0 1 6 0 6 6 6 1 0 6 0 6 0 1 6 6 0 6 6 1 0 6 6 0 1 6 1 6 0 6 1 6 6 1 6 1 0 6 6 7 1 0 0 6 0
1 6 6 6 1 0 6 1 6 1 6 1 0 6 0 6 1 6 1 6 1 6 0 0 1 1 1 6 1 6 0 1 1 1 1 6 0 0 1 1 4 6 1 1 6 1 4 0 6 6 6 6 0 6 0 6 1 0 6 1 6 6 0 6 0 1 0 1 0 6 1 1 6 6 0 1 6 6 1 6 0 1 0 0 1 0 6 6 0 6 0 0 1 6 6 1 1 1 6 6
0 6 1 1 1 1 6 0 0 0 0 1 6 0 6 6 0 6 1 1 0 0 1 6 6 0 6 6 6 1 6 1 1 6 1 6 0 6 0 4 4 4 0 0 4 4 4 0 6 1 0 6 0 6 6 6 6 0 0 0 1 6 0 0 6 6 6 1 1 6 0 6 6 0 0 0 0 0 6 0 0 6 6 1 6 0 1 1 1 0 1 1 6 6 1 0 1 6 6 0
6 0 0 0 1 0 1 0 1 1 1 6 6 1 1 0 6 8 1 6 0 6 0 6 6 1 0 6 0 6 1 0 0 0 6 0 6 6 6 6 1 6 6 6 4 0 4 6 6 1 6 1 0 0 5 1 6 6 1 1 6 6 9 0 0 0 6 0 6 0 0 6 6 0 1 0 6 1 0 0 1 6 0 0 6 0 6 0 6 1 0 6 6 1 6 6 6 1 1 6
6 6 1 0 6 4 4 1 6 0 6 1 6 6 0 1 1 0 6 0 0 0 6 0 6 6 0 1 9 0 0 6 1 1 1 6 6 0 1 0 6 6 1 6 1 1 9 0 6 1 1 0 6 0 1 0 1 6 0 0 6 0 1 1 1 1 0 0 0 6 6 6 0 1 1 0 0 0 0 6 7 6 6 1 6 0 0 1 1 0 1 1 6 6 1 1 6 6 1 6
6 0 6 1 0 4 6 4 9 1 0 1 6 1 6 0 1 6 0 0 0 1 6 6 6 6 1 6 1 6 6 1 0 0 7 1 1 1 5 0 1 1 9 1 1 6 6 6 6 1 6 6 0 6 6 1 6 0 6 6 1 6 1 6 9 1 0 0 0 0 1 0 0 6 6 0 0 0 6 1 6 1 6 6 0 6 1 1 6 6 0 0 9 6 1 0 6 6 1 0
1 6 1 1 1 1 6 0 1 6 6 5 6 6 6 6 1 6 1 1 6 6 0 0 6 6 6 1 1 0 0 6 1 1 1 0 6 0 6 1 1 1 6 0 1 6 0 6 0 1 0 1 1 6 1 1 1 1 0 0 1 6 0 1 1 6 0 6 0 1 6 6 6 0 6 1 1 0 1 0 6 1 6 6 6 6 1 6 6 6 1 6 6 1 1 1 6 1 1 0
1 6 6 6 6 0 1 0 6 1 6 1 6 1 1 6 1 1 1 1 6 1 1 6 0 1 6 0 0 1 1 6 0 1 0 1 0 6 6 0 0 6 6 6 1 1 0 6 1 6 0 1 6 6 1 6 1 0 0 0 0 6 6 0 1 6 1 6 0 0 0 6 1 6 6 0 0 0 0 1 1 6 0 1 6 1 0 0 6 6 6 6 6 1 0 6 1 8 0 1
6 6 0 1 1 0 6 0 6 6 1 6 8 0 6 6 0 1 6 6 0 0 0 1 1 6 1 1 6 6 6 0 1 0 6 0 1 6 6 0 0 6 6 0 0 0 6 6 6 0 1 6 6 0 1 0 0 1 6 1 1 0 1 1 0 1 1 6 6 6 1 1 6 0 6 1 1 0 0 0 1 0 6 1 6 6 6 1 1 6 0 0 0 0 1 0 0 6 6 1
0 6 0 1 0 0 6 0 0 0 0 6 1 0 0 0 6 1 1 8 8 0 1 1 6 6 0 6 1 6 0 6 6 0 8 6 0 1 1 1 0 0 7 6 6 0 0 5 6 6 0 1 0 6 0 1 6 1 8 6 1 6 6 1 0 1 6 0 0 6 1 6 1 1 1 0 1 1 1 1 1 6 1 6 1 6 6 6 1 6 6 0 1 0 1 1 6 0 1 1
6 0 1 1 6 1 6 1 0 6 1 6 6 1 6 0 0 1 0 6 0 6 1 1 0 6 1 0 6 6 1 6 0 1 0 6 1 1 6 6 0 6 6 7 0 1 0 1 6 1 0 1 0 6 1 0 1 6 1 1 0 6 0 1 0 6 9 1 1 0 0 6 0 0 1 0 6 6 6 0 0 6 0 0 0 0 6 0 0 0 6 0 6 1 6 0 1 6 0 6
6 1 0 1 6 6 9 6 0 1 0 0 6 6 6 1 6 1 6 1 0 1 1 6 6 0 0 6 0 6 6 6 6 6 1 0 1 0 0 6 1 1 6 0 6 6 0 0 6 1 1 1 1 0 6 1 6 6 6 6 1 6 1 0 5 6 1 6 1 1 0 6 6 1 6 1 0 6 0 5 1 6 7 0 0 1 0 6 1 6 6 6 6 1 6 6 1 0 0 1
0 6 1 6 1 6 1 6 0 6 1 1 0 0 0 0 0 0 0 6 6 0 0 1 6 6 6 0 6 6 6 0 6 0 6 0 1 6 6 6 1 0 6 6 0 6 0 0 6 6 0 1 0 1 1 6 6 6 0 1 6 0 0 6 6 1 6 6 0 6 1 8 0 6 6 0 8 0 1 6 0 6 0 6 6 1 1 0 0 1 6 1 0 6 0 0 0 1 6 6
