6 6 6 6 0 0 0 1 6 0 0 0 0 6 5 6 1 0 6 6 6 1 6 0 0 6 0 10 10 6 0 1 0 1 0 6 0 10 1 10 1 1 0 1 0 1 0 1 6 0 1 1 1 0 6 1 10 6 0 1 0 1 6 6 1 6 1 1 1 0 0 0 1 1 0 0 6 0 6 6 6 0 6 0 0 6 1 1 0 6 6 6 6 1 6 0 6 6 6 6
6 0 6 0 1 6 1 1 0 1 6 1 1 0 1 0 1 1 0 0 0 6 6 1 0 1 0 10 1 6 1 1 5 0 6 0 0 10 1 10 0 0 6 1 1 0 0 1 0 1 0 0 6 6 6 6 10 6 6 6 6 6 0 0 6 1 6 1 6 0 0 1 0 6 1 0 1 0 6 6 6 0 1 1 1 0 1 1 0 0 1 0 6 1 0 6 0 6 1 1
0 1 0 1 1 0 1 1 1 1 1 1 1 0 1 1 1 1 1 6 0 0 0 1 0 6 6 10 10 0 6 1 6 6 0 1 1 10 0 10 1 0 6 1 1 1 1 6 6 1 0 1 0 1 6 1 10 0 0 6 6 1 0 1 1 0 1 1 6 1 0 0 0 0 6 0 1 6 6 0 1 6 6 6 0 0 0 0 0 0 1 1 1 1 6 6 1 6 0 0
6 1 1 6 1 0 6 1 6 0 6 1 1 6 0 6 1 0 1 1 0 6 0 0 0 0 6 10 0 1 1 0 0 1 1 6 1 10 10 10 1 6 1 1 6 6 1 0 6 1 0 1 0 0 0 1 10 6 1 0 1 1 0 6 6 0 0 1 0 0 6 1 6 6 1 6 1 6 1 1 6 1 1 1 0 1 6 0 1 0 0 6 0 6 6 0 0 0 0 0
6 0 6 0 0 1 0 6 0 6 1 1 1 0 1 0 6 6 0 1 6 6 6 0 6 6 1 10 1 6 0 6 6 6 1 1 6 10 10 10 10 0 6 6 0 1 6 0 0 0 6 1 6 6 0 0 10 1 0 0 6 6 6 6 0 0 0 6 1 1 6 1 6 6 6 0 6 6 0 1 1 1 0 1 0 1 1 6 6 1 0 6 6 6 6 0 1 6 1 0
6 0 6 6 0 1 1 6 0 0 1 6 0 0 0 1 6 6 0 1 6 0 6 6 6 1 10 10 6 6 0 1 0 1 6 1 6 10 0 10 0 1 6 0 1 1 0 6 0 1 1 6 0 0 0 0 10 6 1 6 6 6 6 1 6 1 1 1 1 1 0 6 1 1 0 0 0 6 1 1 6 0 1 1 0 0 6 1 0 0 0 0 0 6 0 1 0 6 1 0
6 1 1 0 1 6 1 1 0 0 6 0 6 0 6 0 1 1 6 1 0 0 0 0 5 1 1 10 10 0 6 6 1 1 6 0 6 10 1 10 10 6 6 0 1 0 1 6 0 1 6 0 6 0 6 0 10 0 0 1 1 1 0 6 1 1 0 6 0 6 6 0 6 6 1 0 1 0 6 6 1 0 0 1 1 6 0 6 0 1 0 0 1 1 1 6 1 1 1 0
1 6 1 6 6 1 0 0 0 1 1 0 1 1 0 1 0 6 1 6 0 6 1 0 0 6 1 10 0 0 1 1 6 1 1 1 0 10 0 10 1 0 1 1 1 6 0 0 0 1 0 6 0 0 1 6 10 6 6 0 0 0 1 0 1 6 0 1 6 6 1 6 6 1 1 1 1 1 1 6 1 6 6 0 0 0 6 6 1 1 1 0 1 0 1 0 6 1 0 0
0 1 6 1 0 1 0 1 6 0 0 0 6 0 0 1 1 6 0 0 6 0 1 6 1 0 6 10 1 6 1 0 6 6 0 6 6 10 10 10 1 6 6 6 1 0 0 1 6 1 0 1 1 6 1 6 10 0 1 1 1 6 0 0 1 6 1 6 1 6 1 1 6 6 0 6 1 1 0 6 1 6 0 1 0 1 1 1 6 0 6 6 0 1 0 6 0 0 0 0
0 1 1 0 6 0 0 0 0 1 1 6 0 6 0 6 0 1 6 0 1 6 6 1 0 6 1 10 1 6 0 6 6 6 6 1 10 10 6 10 1 6 1 6 1 1 1 1 1 0 1 6 1 0 1 6 10 10 1 6 6 1 1 0 0 0 6 1 0 1 6 1 5 0 1 6 6 6 0 0 0 0 6 1 6 0 1 6 6 1 0 1 6 6 0 6 0 1 0 1
0 1 6 0 0 1 6 6 1 0 1 1 6 1 1 6 0 0 6 0 6 0 1 6 0 0 1 10 10 1 1 1 1 6 1 1 10 10 10 10 6 6 6 1 6 1 6 1 0 6 1 6 0 1 0 10 10 6 6 0 6 0 0 0 1 0 0 0 6 1 1 0 6 6 1 1 0 1 0 6 6 1 6 6 0 1 1 1 0 6 0 1 6 6 6 1 0 0 0 1
0 0 1 6 1 6 0 6 6 0 0 1 6 6 6 6 1 0 6 0 1 0 1 1 6 1 6 10 0 0 0 6 1 0 0 0 10 10 0 10 1 0 1 0 0 1 6 1 1 0 1 6 0 6 1 6 10 10 0 6 1 6 0 0 0 1 1 0 0 6 0 1 6 0 6 1 0 6 6 0 0 1 1 1 1 0 1 0 1 1 1 6 1 6 0 1 1 1 0 6
1 1 1 1 1 6 1 1 0 0 0 0 0 1 0 6 1 1 0 0 6 1 1 6 6 1 6 10 10 6 0 0 1 6 1 0 10 10 1 10 0 6 1 1 0 1 0 1 1 6 0 0 0 1 6 0 10 0 1 6 1 1 1 1 6 6 6 1 0 1 6 1 1 1 1 0 0 6 0 1 1 0 6 1 6 0 6 6 0 0 1 6 6 1 1 6 6 1 1 1
1 0 1 0 1 6 0 0 0 0 6 0 1 0 0 1 6 6 6 1 6 1 0 1 6 6 10 10 1 1 0 0 1 0 6 1 1 10 1 10 1 1 0 0 1 0 0 1 0 1 0 6 6 6 6 1 10 1 0 1 1 0 6 0 1 1 0 1 1 1 6 0 0 6 6 0 1 0 0 1 6 0 6 6 0 6 0 6 0 1 0 0 0 1 1 0 0 0 6 1
6 10 6 6 1 1 10 1 6 1 10 1 6 1 6 1 6 6 0 6 10 6 0 6 1 6 10 10 1 1 0 6 0 0 0 1 0 10 0 10 0 0 1 0 1 1 1 1 0 6 0 6 10 0 6 6 10 10 0 1 1 1 1 6 10 1 1 6 1 0 6 0 0 1 0 1 0 0 0 1 1 6 0 10 0 1 10 1 10 10 10 1 6 1 0 0 1 6 0 1
10 10 10 10 10 10 10 10 10 10 10 10 10 10 10 10 10 10 10 10 10 10 10 10 10 10 10 10 10 10 10 10 10 10 10 10 10 10 10 10 10 10 10 10 10 10 10 10 10 10 10 10 10 10 10 10 10 10 10 10 10 10 10 10 10 10 10 10 10 10 10 10 10 10 10 10 10 10 10 10 10 10 10 10 10 10 10 10 10 10 10 10 10 10 10 10 10 10 10 10
6 0 6 1 10 0 6 0 10 10 1 1 6 1 0 1 1 10 0 6 0 1 10 1 0 10 0 10 0 6 0 0 10 10 1 1 10 10 10 10 1 0 6 1 0 1 10 0 0 0 0 1 0 0 6 0 10 10 0 1 0 0 0 6 1 0 6 0 0 0 1 1 6 0 0 0 1 0 0 1 0 6 0 0 1 1 0 6 6 1 0 0 10 0 0 1 0 6 1 1
6 6 6 1 0 1 0 6 0 6 1 1 1 1 1 1 6 1 0 1 6 1 1 1 1 6 6 10 6 1 6 6 1 6 6 0 10 10 1 10 1 1 6 6 6 6 6 6 0 0 0 6 6 0 0 0 10 6 0 1 1 0 0 0 0 0 0 1 1 6 6 0 0 0 1 6 6 0 0 0 1 6 6 6 6 0 1 6 0 0 6 1 1 0 1 1 1 1 0 1
6 1 0 6 6 1 1 1 0 1 1 0 6 0 0 0 1 0 6 6 0 0 6 6 1 0 0 10 0 0 0 6 0 1 1 6 6 10 1 10 10 6 0 0 6 1 0 6 1 6 0 1 0 1 0 0 10 0 0 6 1 0 0 1 1 6 6 1 0 0 0 1 6 1 0 5 1 5 6 0 6 0 0 0 1 1 1 0 1 6 6 1 1 5 6 0 6 0 1 6
0 0 6 0 0 0 1 0 1 6 1 0 6 0 0 0 1 6 6 1 0 6 1 1 1 0 10 10 1 1 1 1 1 6 6 6 1 10 1 10 0 0 0 1 0 6 0 0 6 1 1 1 6 1 6 1 10 1 1 0 6 0 0 1 6 6 0 1 0 1 1 0 1 1 1 0 0 1 1 6 1 0 1 6 0 1 6 1 6 6 1 1 0 1 1 0 6 1 0 6
0 0 6 6 0 0 0 1 6 6 6 0 0 1 0 1 0 6 6 0 6 6 0 1 1 1 6 10 6 6 0 1 0 6 1 0 10 10 0 10 0 6 0 0 0 0 1 0 6 0 6 1 0 6 0 1 10 10 1 0 0 1 6 1 6 6 1 1 1 1 0 0 1 1 6 1 1 0 0 0 1 6 1 6 6 5 1 6 0 1 6 6 1 6 0 6 1 6 1 6
0 1 0 0 1 0 6 0 0 1 0 6 0 1 6 1 1 0 0 6 5 0 0 0 0 1 6 10 0 0 6 6 0 6 6 1 0 10 10 10 0 0 1 1 1 6 1 1 0 0 1 6 0 1 1 6 10 1 1 1 6 1 1 6 6 1 0 6 0 6 6 6 1 1 1 6 1 1 0 1 6 6 6 0 1 1 6 1 0 1 1 1 6 0 0 1 6 0 5 1
1 1 0 1 0 1 1 0 1 0 0 1 6 0 6 0 1 1 0 0 0 1 0 1 1 0 10 10 6 6 0 1 1 0 6 0 10 10 6 10 0 0 0 1 0 6 1 6 1 0 5 0 0 0 0 1 10 0 6 5 0 6 6 0 0 0 5 0 0 6 0 0 1 6 6 1 1 0 0 0 1 6 1 1 1 0 1 6 0 6 6 6 6 0 6 1 0 0 0 1
6 0 0 6 1 1 6 0 0 6 0 6 6 0 6 6 1 0 0 6 0 1 0 6 0 1 0 10 1 1 6 0 6 0 1 0 6 10 1 10 1 1 1 6 1 0 6 6 1 0 1 0 1 6 0 10 10 6 0 6 1 1 6 6 6 1 1 1 1 1 6 1 0 1 6 1 1 0 1 6 0 0 1 6 0 0 1 1 0 1 0 1 1 0 0 6 0 0 6 0
6 1 1 6 6 0 0 0 0 1 1 6 0 1 0 0 6 6 0 6 6 6 0 0 1 1 6 10 10 0 6 0 6 6 1 0 1 10 0 10 0 0 0 1 0 6 0 0 0 6 6 6 6 1 0 6 10 0 1 0 6 1 0 1 1 0 6 6 6 6 1 0 6 1 0 1 0 0 0 0 1 0 1 1 0 6 6 6 0 0 6 1 0 6 6 6 6 6 6 6
6 6 1 1 1 0 0 0 0 0 1 0 0 0 6 1 6 1 1 0 1 1 0 1 6 0 1 10 1 0 6 0 0 0 6 1 0 10 10 10 1 0 0 1 1 1 6 0 6 0 0 1 6 1 1 10 10 6 0 1 0 1 0 1 0 1 0 6 0 1 6 0 6 1 1 6 1 1 0 1 0 6 1 6 0 6 6 6 6 0 0 1 1 0 6 5 6 6 1 1
0 6 1 0 0 1 1 1 0 6 0 6 0 0 0 6 6 6 1 1 1 1 0 0 0 1 0 10 0 0 6 6 6 1 6 0 6 10 10 10 0 6 1 6 1 6 6 1 6 0 0 0 1 0 0 1 10 10 1 6 0 0 0 6 6 0 0 1 6 0 1 6 0 0 1 0 6 0 0 6 0 6 0 1 0 6 0 0 1 0 0 6 0 1 0 1 1 0 1 1
6 6 1 0 0 0 1 0 0 1 0 6 6 6 6 6 0 6 0 6 6 0 6 0 0 1 0 10 0 6 0 1 6 0 6 1 6 10 0 10 6 1 6 6 0 1 6 6 1 1 1 0 1 1 0 10 10 1 1 1 6 1 6 6 0 1 0 1 6 6 6 0 0 1 0 0 1 6 0 6 0 1 1 0 1 0 0 6 0 6 6 0 0 0 0 6 6 1 6 6
6 0 6 1 0 0 1 0 6 6 0 6 6 6 0 1 0 0 1 0 0 1 6 0 0 1 1 10 6 6 0 1 0 0 1 0 10 10 0 10 6 0 5 1 0 1 1 1 0 0 1 6 1 0 1 1 10 10 0 6 1 0 0 6 0 6 6 0 1 0 0 1 1 1 1 1 0 6 0 0 1 6 6 0 0 0 6 6 0 0 1 0 6 0 1 0 1 1 1 6
1 6 1 0 6 6 6 6 1 1 6 6 1 0 6 6 1 1 0 0 0 0 1 6 6 0 1 10 1 0 6 0 0 6 1 6 6 10 0 10 6 0 1 6 1 6 6 1 1 6 1 1 1 6 6 6 10 6 6 1 0 0 6 0 1 6 0 1 6 1 0 1 0 6 1 0 0 1 1 1 6 1 0 1 0 0 0 1 1 1 6 6 6 0 1 1 6 0 6 0
10 10 5 1 1 1 0 1 6 0 1 1 1 6 1 6 1 0 0 1 6 0 6 0 1 6 0 10 0 10 5 0 10 6 6 1 0 10 1 10 1 10 6 6 1 0 6 0 10 1 0 6 6 6 0 10 10 1 0 1 6 0 1 0 0 10 0 10 0 0 0 6 6 0 6 1 0 1 10 1 0 6 1 0 6 0 0 6 10 1 6 6 6 0 10 0 10 6 10 1
10 10 10 10 10 10 10 10 10 10 10 10 10 10 10 10 10 10 10 10 10 10 10 10 10 10 10 10 10 10 10 10 10 10 10 10 10 10 10 10 10 10 10 10 10 10 10 10 10 10 10 10 10 10 10 10 10 10 10 10 10 10 10 10 10 10 10 10 10 10 10 10 10 10 10 10 10 10 10 10 10 10 10 10 10 10 10 10 10 10 10 10 10 10 10 10 10 10 10 10
1 0 0 0 0 0 10 0 1 6 0 6 0 6 1 10 1 0 1 6 6 1 0 1 1 6 10 10 10 1 10 10 1 6 0 0 1 10 10 10 10 6 6 6 1 6 10 0 0 10 10 6 6 1 0 0 10 0 0 1 0 1 1 10 10 0 6 1 0 0 0 0 6 6 0 1 1 0 6 10 1 0 1 1 6 1 1 1 6 6 0 6 10 10 6 1 1 0 1 1
0 0 6 0 6 0 0 1 1 0 6 0 0 0 1 0 6 1 1 6 6 0 1 1 0 1 6 10 6 6 6 6 1 0 0 0 10 10 1 10 0 0 6 0 0 0 6 1 6 0 6 0 6 0 0 6 10 0 6 6 1 1 1 6 6 6 0 1 1 1 0 1 1 0 0 1 1 0 0 1 6 1 1 6 0 0 1 1 6 6 0 1 6 6 1 6 0 0 0 0
0 6 6 1 0 6 6 0 6 1 0 0 6 1 1 1 0 0 0 6 0 0 6 0 6 0 1 10 1 1 1 1 1 1 0 6 6 10 1 10 1 0 0 0 1 6 6 1 0 1 1 1 1 0 1 6 10 0 1 0 6 1 1 1 6 1 6 1 0 5 6 6 6 0 6 6 6 0 0 1 0 0 1 1 6 1 6 1 0 0 1 0 1 6 1 0 0 6 0 6
6 6 1 6 1 0 0 1 0 6 1 1 6 0 6 1 1 0 0 6 1 6 1 1 6 6 1 10 6 0 0 1 1 1 0 0 0 10 1 10 0 1 0 6 0 1 0 1 6 1 1 1 0 0 1 6 10 0 1 1 0 1 0 0 0 5 1 6 1 0 6 1 1 6 0 1 0 0 0 6 6 0 0 1 1 1 0 1 6 1 0 1 6 0 0 6 6 6 1 6
0 0 0 0 6 6 1 6 6 1 6 0 0 1 1 0 1 1 6 1 6 0 0 0 0 1 0 10 1 0 0 1 1 6 1 1 1 10 6 10 10 6 1 0 6 0 0 0 6 1 6 0 1 0 6 6 10 1 0 6 6 0 6 0 1 0 0 6 1 1 6 0 6 6 1 1 6 0 1 0 1 6 6 0 1 6 1 0 1 1 1 0 6 0 1 6 6 6 0 0
0 0 6 1 1 0 0 0 1 6 1 1 6 6 6 0 6 1 1 0 6 6 0 1 1 1 10 10 1 1 0 1 6 1 0 0 1 10 1 10 6 1 0 1 6 1 0 1 0 6 1 0 0 6 6 1 10 1 1 1 6 6 1 1 1 6 0 6 6 6 0 0 6 0 1 1 1 0 0 0 6 1 0 6 6 6 0 1 0 1 1 6 1 0 0 6 6 0 0 0
0 1 1 0 6 6 6 0 6 1 6 6 0 1 0 6 0 1 6 6 1 0 0 1 6 0 6 10 1 6 1 0 6 0 0 1 0 10 10 10 0 6 1 0 0 6 6 6 0 0 1 6 0 6 6 6 10 0 1 6 0 6 6 0 1 0 0 6 0 6 1 6 1 6 6 0 6 0 1 6 0 0 1 0 6 1 1 1 1 6 0 1 0 1 0 1 6 1 1 6
0 1 1 0 6 1 0 0 6 1 5 1 6 1 0 6 1 6 6 1 0 0 0 6 6 1 1 10 0 6 0 6 0 6 6 0 10 10 10 10 6 6 0 1 1 1 6 0 6 1 1 6 1 0 0 6 10 10 0 0 0 0 1 0 1 1 6 6 6 1 1 0 1 6 6 6 6 1 0 1 1 1 1 6 0 6 1 6 1 6 6 0 6 0 0 0 1 1 1 6
6 1 6 1 1 1 0 0 0 1 0 0 1 1 0 1 0 0 1 0 1 6 0 6 1 1 0 10 1 0 6 0 1 6 1 6 6 10 10 10 0 0 1 6 1 1 1 0 1 1 1 0 0 0 0 0 10 1 1 1 1 1 1 6 0 1 0 6 1 1 1 0 0 0 6 0 6 1 0 1 6 1 1 1 1 1 0 1 0 0 0 1 6 1 6 0 0 6 1 0
1 0 6 0 1 1 0 1 0 1 1 1 0 1 1 6 0 0 1 6 0 1 1 6 0 1 1 10 0 1 0 1 6 0 0 1 0 10 0 10 1 0 11 11 11 11 6 1 11 11 11 11 11 11 11 11 11 6 6 1 6 0 0 1 6 0 1 1 0 6 1 0 6 1 6 6 1 6 0 6 1 1 1 6 6 1 6 1 0 0 0 1 6 1 1 6 1 1 1 0
1 1 0 0 6 1 1 6 0 0 0 6 0 1 0 6 6 6 1 6 1 5 0 0 6 6 1 10 0 6 0 6 0 6 0 6 0 10 1 10 0 1 11 11 11 11 11 11 11 6 1 11 11 11 11 11 11 6 6 6 6 1 6 1 0 1 0 0 0 6 0 6 1 1 0 1 1 0 0 0 1 0 0 1 6 6 0 6 0 1 6 1 6 6 1 0 1 0 6 6
1 0 1 0 1 6 0 6 1 6 0 1 1 1 1 1 1 1 1 0 6 6 6 6 1 6 0 10 6 6 0 0 0 6 6 1 1 10 10 10 0 6 11 11 11 11 11 11 11 11 11 11 11 11 11 11 11 0 1 1 1 1 0 0 1 0 0 6 6 0 0 0 1 1 1 0 6 0 0 1 0 1 0 6 0 6 0 6 0 6 1 0 1 0 1 1 6 1 6 0
6 6 0 1 0 1 1 1 1 0 6 6 6 1 0 0 1 6 6 0 0 6 6 0 1 0 0 10 1 6 6 0 1 0 6 6 0 10 1 10 0 1 11 11 0 11 11 11 11 11 11 11 11 11 0 11 11 6 6 6 6 6 0 1 6 0 1 6 0 0 6 0 1 6 6 6 6 0 6 0 0 0 6 0 1 0 6 0 6 1 1 6 0 0 0 0 1 1 0 1
0 1 1 0 6 6 6 1 0 6 0 6 0 1 0 1 1 6 6 0 1 1 6 1 0 1 6 10 0 1 6 1 6 1 0 0 10 10 10 10 1 1 11 11 11 0 11 11 11 0 11 11 1 11 11 11 11 6 1 6 0 1 6 1 6 1 0 0 1 1 0 1 6 1 1 1 0 6 1 1 0 0 1 1 6 0 0 0 1 1 1 1 1 0 0 6 1 0 1 1
1 6 0 0 1 6 0 1 0 1 1 0 1 0 1 1 0 1 1 0 1 6 0 1 0 6 1 10 10 0 0 6 6 1 6 0 1 10 1 10 0 6 11 11 11 11 11 11 11 11 11 11 11 11 11 11 11 1 6 0 0 1 6 0 1 6 1 0 6 0 0 0 6 0 0 0 1 0 0 1 1 6 6 6 1 6 0 0 6 0 0 6 0 6 1 6 0 6 1 1
1 1 6 0 0 6 1 0 0 1 0 1 1 6 0 6 6 0 0 1 0 1 0 6 0 1 1 10 10 0 1 1 6 6 6 6 6 10 1 10 1 6 11 11 11 11 11 11 11 0 11 1 11 11 11 11 11 1 1 0 0 1 6 1 6 1 0 6 6 1 0 6 0 6 1 0 1 1 1 0 0 1 6 6 0 6 1 1 1 1 0 1 0 0 0 1 6 0 1 6
0 1 6 1 1 1 6 1 1 0 0 1 0 6 1 1 0 0 1 1 0 0 0 6 6 0 0 10 10 6 0 0 6 1 0 6 1 10 10 10 1 1 11 11 1 11 0 11 11 11 11 11 11 11 11 1 11 5 1 6 1 1 0 0 1 0 0 0 1 1 6 6 0 0 1 6 6 6 1 0 1 6 6 6 0 6 1 6 6 1 1 0 1 1 6 0 6 6 6 6
1 1 0 6 0 0 0 0 0 6 0 1 0 6 6 1 0 0 0 1 1 1 6 1 1 6 10 10 6 1 1 6 6 1 0 6 0 11 11 11 11 11 11 11 11 11 11 11 11 11 11 11 11 11 6 11 10 1 6 1 0 0 1 1 1 1 0 6 0 1 0 1 6 1 0 1 1 6 0 0 6 1 1 5 1 0 6 0 6 0 0 1 0 0 6 0 1 6 1 1
1 1 1 0 1 1 1 6 1 6 0 6 1 1 6 1 1 6 1 0 1 6 6 6 1 0 1 10 1 6 1 0 0 6 1 6 10 11 11 11 11 11 11 11 11 11 11 11 11 11 11 11 11 11 11 11 11 1 0 1 1 6 6 6 6 6 0 0 6 1 6 6 0 1 0 6 1 0 6 1 1 6 6 6 1 1 6 0 0 0 0 0 0 1 6 1 6 0 6 0
1 6 6 1 1 0 1 6 1 6 6 6 1 1 1 1 1 0 1 0 1 1 1 0 0 0 1 10 10 1 6 1 6 6 0 0 1 11 11 11 11 11 11 11 11 1 11 11 11 11 11 11 1 0 11 11 10 10 1 6 0 0 6 0 0 0 0 1 0 1 0 6 6 1 6 1 0 6 1 1 1 1 1 1 1 6 0 0 6 1 0 0 0 0 1 0 0 0 0 6
1 6 0 6 6 0 6 6 6 1 0 0 0 0 1 1 0 0 0 6 1 0 6 1 1 0 0 10 10 1 6 0 6 1 1 6 1 11 11 11 11 11 11 11 11 11 11 11 11 11 11 11 11 11 11 11 10 0 6 6 0 0 1 0 0 6 1 1 0 0 0 1 1 1 0 1 1 6 6 1 6 0 6 6 6 6 0 1 6 6 1 6 1 0 1 6 0 0 6 0
6 0 0 1 6 0 0 6 1 1 0 0 6 0 1 1 1 1 6 1 6 1 6 1 0 0 10 10 6 6 6 0 6 0 1 6 0 10 11 11 11 11 11 11 11 11 11 11 11 11 11 11 11 6 11 11 11 6 0 1 1 6 0 6 0 1 0 6 1 0 1 0 6 6 6 0 0 0 0 0 1 0 1 6 0 1 1 0 0 0 0 6 6 0 6 0 0 1 6 0
6 0 0 0 6 0 6 1 6 0 0 6 6 6 1 0 6 1 0 0 1 6 0 1 1 0 6 11 11 6 11 11 11 11 11 11 0 11 11 11 11 11 11 11 11 11 11 11 11 11 11 11 11 11 11 11 11 6 0 6 0 0 0 1 1 6 1 1 0 6 1 6 1 6 6 1 0 1 6 1 6 0 1 0 1 0 1 6 0 6 6 1 6 1 6 1 1 1 0 1
0 0 6 0 0 1 1 1 0 0 6 1 1 6 6 6 0 1 6 1 6 0 6 0 6 0 1 10 11 0 11 11 11 0 0 11 6 11 11 11 11 11 11 11 11 11 11 11 0 11 11 11 0 11 11 11 11 1 0 1 6 0 1 0 1 1 0 1 1 0 6 6 1 0 6 1 1 6 6 0 1 1 1 1 6 0 0 6 1 1 0 0 6 1 0 1 0 6 6 1
6 6 0 1 1 1 6 6 1 1 1 6 6 0 6 6 0 0 1 1 1 1 0 6 0 1 6 11 11 11 11 11 11 11 11 11 11 10 11 11 11 11 11 11 11 11 11 11 11 11 11 6 6 1 1 10 10 1 6 6 6 6 1 1 6 0 0 6 6 1 1 0 1 1 0 0 0 0 0 1 0 1 6 1 0 0 0 0 1 1 6 0 1 1 1 0 1 1 1 0
1 6 6 1 6 1 6 1 6 6 6 1 1 6 0 1 1 6 1 6 1 0 6 0 6 1 10 11 11 11 11 11 0 11 11 11 11 11 11 11 11 11 0 11 0 11 11 11 11 11 11 11 1 1 0 6 10 1 1 1 6 6 1 0 0 1 6 0 0 0 1 1 6 0 6 0 0 1 1 0 0 0 0 0 6 0 1 0 1 1 1 0 1 0 0 0 6 0 1 1
0 1 0 1 0 0 1 0 0 0 6 1 1 0 1 6 1 1 6 0 0 1 0 1 6 0 1 10 11 11 11 11 1 11 11 11 11 11 11 11 11 11 11 11 11 11 11 11 11 11 11 11 6 0 6 1 10 10 1 0 0 0 0 6 0 0 0 6 0 6 1 6 6 0 6 1 1 6 5 1 6 6 0 0 1 1 1 0 1 1 0 0 1 6 0 6 6 1 6 6
0 1 1 6 0 0 1 0 6 6 6 1 0 1 0 0 0 0 0 0 1 1 0 0 0 0 1 11 6 11 11 11 11 11 0 11 11 11 11 11 11 11 0 11 6 11 11 11 11 11 11 1 1 0 6 6 10 1 1 1 0 1 0 6 0 6 0 0 6 1 0 0 0 1 1 0 0 1 6 0 0 1 6 6 0 0 1 1 6 6 1 1 1 6 6 6 0 6 0 1
1 0 0 0 6 6 6 1 0 0 0 0 0 6 0 0 1 1 0 1 1 1 0 6 6 1 1 11 11 11 1 11 11 11 11 11 11 11 11 11 11 11 6 11 0 11 11 11 11 6 11 6 6 0 0 1 10 10 0 1 6 0 1 6 6 1 6 1 6 0 6 6 1 0 1 0 6 6 0 0 6 0 0 6 6 6 0 0 0 0 6 6 0 1 1 1 6 0 6 0
6 1 1 1 0 0 0 6 1 6 0 1 6 0 1 6 0 6 1 6 0 6 1 1 6 1 1 10 11 11 11 11 11 11 11 11 11 11 11 11 11 11 11 11 11 11 6 6 11 11 11 11 6 1 1 0 10 0 6 0 1 6 6 1 6 1 1 6 0 0 6 6 6 0 0 0 6 0 6 6 6 0 0 0 1 6 1 0 0 6 1 0 1 0 1 6 6 1 1 0
1 1 6 6 1 1 6 6 0 0 5 6 1 0 1 1 0 1 1 0 6 1 1 6 6 0 0 11 0 11 1 11 11 11 11 11 11 11 11 11 11 11 11 0 6 0 11 11 11 11 11 11 6 6 6 6 10 1 1 6 6 1 0 0 1 1 1 6 1 6 6 0 0 1 0 0 1 6 0 1 6 1 0 0 6 1 6 0 1 1 6 1 1 0 0 1 1 0 1 1
6 0 6 6 0 1 6 6 0 1 10 0 1 0 0 10 6 6 0 6 0 1 1 6 6 1 10 11 11 11 11 11 11 11 11 1 11 11 11 11 11 11 11 11 6 11 11 11 11 11 11 11 0 1 6 10 10 0 0 1 6 0 1 0 6 6 6 0 6 1 1 6 0 10 6 10 0 6 0 1 10 6 0 0 6 10 6 1 6 6 0 1 1 6 0 0 10 10 0 10
10 10 10 10 10 10 10 10 10 10 10 10 10 10 10 10 10 10 10 10 10 10 10 10 10 10 10 11 11 10 11 11 11 11 11 11 11 11 11 10 11 11 10 10 10 10 10 10 10 10 10 10 10 10 10 10 10 10 10 10 10 10 10 10 10 10 10 10 10 10 10 10 10 10 10 10 10 10 10 10 10 10 10 10 10 10 10 10 10 10 10 10 10 10 10 10 10 10 10 10
1 0 1 6 1 0 10 10 1 6 0 1 1 10 6 1 0 1 10 6 1 6 1 6 1 1 6 11 11 11 11 11 11 11 11 1 11 11 11 11 11 11 0 6 0 10 1 1 0 0 6 0 0 10 10 10 10 0 0 6 0 10 6 6 10 6 6 10 1 0 10 10 6 1 0 1 6 1 0 0 0 6 1 6 10 6 1 6 1 1 6 10 0 1 1 0 6 1 0 1
1 6 1 6 6 0 6 0 0 1 6 1 1 6 0 6 6 6 1 6 1 6 0 0 6 1 0 11 11 6 11 11 11 11 11 0 0 11 11 11 11 11 0 0 0 1 6 6 6 6 0 0 0 1 6 0 10 1 6 1 0 1 6 1 0 6 6 6 6 1 6 6 0 1 1 0 0 6 6 6 6 0 1 1 6 1 0 0 6 6 6 1 0 6 0 0 6 0 6 6
6 6 6 1 1 6 6 1 0 1 0 6 1 0 1 0 1 0 0 1 1 1 1 0 6 1 1 11 11 11 11 11 11 1 11 11 11 11 11 11 11 11 1 6 0 6 0 6 0 6 0 1 0 0 1 0 10 1 0 6 0 1 1 1 1 0 1 0 6 1 1 1 1 6 1 0 0 6 1 0 0 0 1 6 1 1 6 6 0 1 1 6 6 0 0 6 6 1 1 1
1 1 0 0 0 1 0 0 1 0 0 0 0 1 6 0 6 0 1 1 1 0 1 0 0 1 10 11 11 11 1 11 11 11 11 0 11 11 11 11 11 11 1 6 1 1 1 6 6 1 6 5 0 0 1 6 10 1 0 6 0 6 1 0 6 6 1 0 6 0 6 0 0 0 6 6 0 6 6 6 0 0 6 1 6 6 1 6 6 6 1 0 1 0 0 6 1 6 1 0
6 6 0 1 1 1 0 1 1 0 1 6 1 0 1 0 0 1 0 1 0 0 0 0 1 0 0 10 6 0 1 0 1 6 0 0 0 10 6 10 10 0 6 6 0 0 0 0 6 0 6 6 5 1 0 0 10 0 0 0 6 0 6 0 0 0 1 0 0 0 1 0 0 0 6 6 0 6 0 1 0 6 1 1 0 1 6 1 6 0 6 0 1 0 6 0 6 0 6 0
0 1 6 6 1 6 1 1 6 6 0 1 1 1 0 1 1 1 6 1 6 1 0 0 0 1 10 10 1 0 1 1 1 1 1 6 1 10 1 10 0 1 0 0 6 0 6 0 0 0 1 0 0 6 0 10 10 6 1 0 1 1 1 1 1 0 1 1 1 6 0 6 1 6 6 1 6 6 1 0 1 1 1 1 1 0 6 6 6 0 0 0 1 6 0 1 0 6 0 0
1 6 0 6 1 1 6 1 6 6 1 0 6 0 0 1 6 1 0 0 1 0 0 0 1 0 10 10 0 0 0 1 1 6 1 1 6 10 1 10 10 6 6 0 0 6 0 1 6 6 6 6 6 0 1 0 10 10 1 1 6 1 1 0 6 6 0 6 0 1 1 6 1 0 1 0 1 0 6 1 0 1 0 6 0 6 0 1 6 1 6 1 6 6 6 6 0 6 1 0
6 1 1 6 1 6 6 1 6 0 0 6 1 0 0 1 1 0 0 1 0 6 6 0 6 1 6 10 0 0 0 6 0 1 6 1 1 10 6 10 1 1 0 1 1 6 6 1 0 1 6 0 1 6 0 1 10 6 6 6 6 1 6 0 0 6 1 0 6 1 0 1 1 1 1 0 1 6 0 6 1 1 1 1 0 0 1 6 1 6 1 0 6 6 0 6 1 1 0 0
0 0 0 0 0 6 1 1 1 0 1 0 6 6 1 6 0 1 0 0 6 1 0 1 6 1 1 10 6 1 1 0 6 0 6 1 1 10 1 10 0 1 1 11 0 11 11 11 11 11 11 11 11 6 11 11 11 11 0 6 6 0 1 1 1 6 6 0 1 0 0 6 1 0 6 0 0 1 1 6 6 0 0 1 1 6 1 1 0 0 0 0 0 6 0 0 1 6 1 0
6 1 0 1 0 0 1 0 6 1 1 6 0 1 0 0 0 6 6 0 6 6 0 11 11 11 11 10 11 11 11 1 11 11 11 11 11 10 1 10 6 0 1 11 11 11 11 11 11 11 11 11 11 11 11 11 10 11 6 1 6 6 6 0 1 0 6 1 0 1 1 0 0 6 6 1 6 0 6 0 0 1 1 1 0 6 1 0 1 0 0 6 0 0 0 6 6 0 6 6
6 0 6 1 6 1 6 1 6 0 0 0 1 0 1 0 1 1 0 6 1 1 0 11 11 11 11 11 11 11 11 0 11 11 11 11 11 11 10 10 1 6 6 11 11 1 6 11 6 0 11 11 11 11 11 11 11 11 6 1 0 1 1 0 11 11 11 11 1 11 11 11 11 11 11 11 11 11 0 6 1 6 1 0 0 0 1 6 0 0 6 1 1 1 1 6 6 0 0 1
1 1 0 0 1 6 6 0 1 6 6 0 0 1 1 0 1 6 6 0 1 1 1 11 11 11 11 10 11 1 6 11 11 11 11 11 11 11 10 10 6 6 0 11 11 11 11 0 6 11 11 11 11 11 11 10 11 11 6 1 0 0 1 11 11 11 11 11 11 11 11 11 0 11 11 11 11 11 1 6 6 6 6 1 1 6 0 0 1 0 6 6 1 0 1 0 1 6 1 1
6 6 0 1 6 1 0 0 0 6 0 0 6 6 1 0 6 0 0 1 6 6 6 11 11 11 11 10 1 11 11 0 11 11 11 11 11 11 6 10 1 0 0 11 6 1 11 11 1 11 11 11 11 11 11 0 11 11 0 1 6 0 1 11 11 11 11 11 11 11 11 11 11 11 11 11 11 11 0 6 0 1 1 0 1 6 0 1 1 0 6 1 6 6 6 6 6 6 1 1
5 5 0 0 1 6 6 0 6 0 0 1 6 6 1 0 6 0 1 1 6 1 0 11 11 11 11 11 11 1 11 11 0 11 11 11 6 11 10 10 6 0 0 6 1 11 11 11 11 11 11 11 11 11 11 11 11 11 0 1 0 0 0 11 11 11 11 11 11 11 11 11 11 0 11 11 11 11 6 6 6 0 0 0 1 1 6 1 0 1 0 0 6 0 0 0 6 6 0 6
1 6 0 1 0 1 1 6 0 1 6 1 0 1 6 1 6 1 1 1 0 0 0 11 11 11 11 10 11 11 11 0 11 11 11 0 1 11 10 10 0 1 0 11 11 11 11 6 11 11 11 11 11 1 11 11 11 11 1 0 6 1 0 11 11 0 11 11 11 11 11 1 1 1 11 11 11 11 1 6 1 0 6 0 6 0 6 0 1 0 0 0 1 1 0 6 6 0 0 0
6 1 1 0 6 0 0 0 0 1 1 1 6 6 0 6 6 1 1 1 6 0 0 11 11 11 11 11 11 11 11 11 11 11 11 11 11 11 0 10 1 1 6 11 11 11 11 11 0 1 11 11 11 11 0 11 11 11 0 6 1 0 0 11 11 11 11 11 11 11 11 11 11 11 11 1 11 6 0 0 6 0 1 6 1 0 6 6 6 1 1 0 6 0 1 0 1 1 0 0
0 6 1 1 6 1 0 6 6 0 0 1 5 0 6 1 0 1 0 6 6 0 1 11 11 11 11 11 11 11 11 11 11 11 11 11 11 11 0 10 10 1 0 11 11 11 11 11 11 11 11 11 11 11 11 11 11 6 1 1 0 1 1 11 11 0 11 11 11 11 11 0 11 11 11 11 11 11 0 6 0 6 0 6 6 0 1 6 6 1 6 1 6 1 1 0 0 6 1 1
0 6 0 6 1 1 6 1 1 0 0 6 6 1 0 6 1 6 6 0 1 1 0 11 6 11 11 11 11 11 0 6 11 1 11 11 11 11 0 10 0 6 0 11 6 11 11 11 11 11 11 11 11 11 11 11 11 11 1 0 0 6 1 11 11 11 11 11 11 11 11 11 11 11 11 11 11 11 6 0 0 0 1 0 0 6 0 5 6 1 0 6 6 1 0 6 1 1 6 1
1 6 1 1 1 0 10 6 6 6 6 6 0 1 6 1 1 6 6 6 6 1 0 11 11 11 11 11 11 11 11 11 11 6 11 11 11 10 10 10 6 6 6 11 11 11 6 11 11 11 11 11 11 1 6 11 10 11 10 6 6 1 6 11 1 11 11 11 6 11 11 11 11 11 11 11 11 11 6 0 0 6 1 6 0 10 6 1 1 1 6 6 6 6 0 1 10 0 6 10
10 10 10 10 10 10 10 10 10 10 10 10 10 10 10 10 10 10 10 10 10 10 10 11 10 10 10 11 10 11 11 11 11 11 11 11 11 11 10 10 10 10 10 10 11 11 11 10 11 11 11 11 11 10 11 11 11 11 10 10 10 10 10 11 11 11 11 11 11 11 11 11 11 11 11 11 11 11 10 10 10 10 10 10 10 10 10 10 10 10 10 10 10 10 10 10 10 10 10 10
1 0 6 6 6 0 6 6 6 6 0 10 6 10 10 1 0 0 6 0 0 1 10 11 11 11 11 11 11 11 11 11 11 11 11 1 6 10 10 10 6 6 10 6 11 11 11 11 11 11 11 11 6 11 6 11 11 1 6 0 0 1 0 11 11 11 11 11 1 0 11 1 11 11 11 11 1 11 6 10 0 10 1 6 6 1 6 0 0 1 10 0 6 0 1 1 6 6 1 0
0 1 1 0 1 6 1 1 1 6 1 1 1 0 6 6 1 0 6 6 0 0 0 6 6 11 11 11 1 11 11 11 11 1 11 11 11 11 6 10 1 0 1 11 11 11 11 11 11 1 11 11 11 1 11 11 11 11 0 1 0 1 0 11 11 11 11 11 11 11 11 11 11 11 11 11 11 11 0 6 6 6 1 0 0 6 6 1 1 6 6 6 0 1 6 1 0 0 0 0
1 6 0 1 0 0 1 0 0 0 1 1 6 0 1 0 6 0 0 6 0 0 0 11 0 1 11 11 11 11 11 11 11 11 11 6 0 10 0 10 0 1 1 11 1 11 11 11 11 11 6 11 11 1 0 6 11 11 1 0 1 1 1 6 11 11 11 11 11 11 11 11 6 11 11 11 11 11 1 0 1 0 6 6 6 1 1 6 0 0 1 6 1 0 6 0 1 1 6 6
1 6 6 6 6 0 0 1 1 0 1 6 6 0 6 1 0 6 0 1 1 0 6 11 0 11 11 11 11 11 0 11 1 0 0 11 11 11 10 10 6 0 0 0 0 1 1 0 0 0 6 6 6 0 5 6 10 5 6 0 1 6 1 11 11 11 1 11 11 11 1 11 11 11 11 11 11 11 1 0 6 6 0 0 5 0 0 0 0 6 1 6 0 0 6 6 6 1 0 1
0 6 6 0 1 1 6 6 1 0 1 0 1 6 1 6 0 0 0 1 1 6 1 0 6 0 6 10 10 0 6 1 6 6 6 6 0 10 10 10 0 6 6 1 6 1 1 1 0 6 0 1 1 1 0 1 10 0 0 0 0 1 0 11 11 11 11 11 1 11 11 1 11 11 11 0 11 11 6 1 1 6 1 6 0 1 0 1 1 1 6 6 1 1 0 6 0 0 1 0
1 0 1 1 0 0 6 6 0 0 1 6 0 0 6 6 0 1 6 6 5 0 6 1 6 6 1 10 1 0 1 1 1 1 1 6 0 10 10 10 6 0 1 1 1 6 1 1 6 1 1 0 1 6 6 10 10 0 6 0 0 0 6 6 6 0 1 1 0 6 0 0 0 1 6 6 6 0 0 0 1 6 1 0 1 1 0 0 0 1 0 6 6 6 6 0 0 0 0 6
0 6 0 0 0 1 6 6 6 6 1 0 1 0 1 6 0 6 1 1 0 6 1 6 1 0 6 10 10 6 0 6 1 0 1 6 10 10 0 10 0 0 1 1 6 0 6 0 1 1 1 0 0 6 6 1 10 1 0 6 6 6 1 0 0 6 1 1 6 0 6 1 6 1 6 6 0 1 0 1 6 0 0 1 0 0 0 0 1 1 6 1 6 6 0 1 1 6 1 1
1 6 0 1 6 6 6 0 0 6 1 0 0 6 0 6 0 6 1 1 6 6 1 0 6 1 6 10 0 6 1 1 0 0 0 0 6 10 1 10 1 0 0 0 1 0 6 0 6 0 0 0 1 6 0 1 10 10 1 1 6 0 6 0 6 1 6 0 6 0 1 0 0 0 0 1 6 0 0 1 1 0 1 6 6 0 1 6 1 6 0 6 6 6 1 1 1 1 6 0
6 6 0 1 6 0 6 0 0 1 1 1 1 1 1 0 1 1 0 0 1 0 6 0 6 0 0 10 0 1 0 1 0 6 1 1 0 10 0 10 6 0 1 1 1 0 1 1 6 0 6 1 1 1 1 1 10 0 1 1 1 1 1 0 0 6 1 0 0 6 0 6 1 1 0 0 1 1 1 6 6 6 6 1 1 1 6 1 1 0 0 0 6 6 6 1 6 0 0 1
6 1 0 1 1 6 6 1 6 6 1 6 6 1 0 1 6 1 0 6 0 6 6 0 0 1 1 10 0 0 1 1 0 0 1 0 1 10 0 10 10 0 1 0 1 6 1 0 6 6 0 1 1 6 0 6 10 1 6 6 6 6 1 6 0 6 1 0 6 6 0 0 1 6 6 0 6 0 1 1 6 1 0 0 0 1 6 0 1 0 6 6 0 0 1 1 6 1 1 6
0 0 6 1 0 0 5 6 0 6 1 0 0 1 0 6 0 1 0 6 0 1 0 0 0 0 0 10 1 1 1 6 6 6 0 6 10 10 1 10 6 6 1 1 0 6 6 1 6 6 1 1 1 0 6 0 10 1 1 0 0 6 6 1 6 1 6 6 6 1 0 6 6 0 1 0 1 6 1 0 0 6 0 0 1 0 1 0 6 1 6 6 0 0 6 1 6 1 1 1
6 1 6 1 6 1 0 1 1 0 0 0 1 0 0 1 6 0 6 6 6 1 1 6 6 6 0 10 0 6 1 6 1 0 0 0 1 10 0 10 0 6 0 0 0 6 6 6 6 6 0 6 0 0 1 6 10 6 0 6 6 0 6 1 0 6 0 0 6 1 1 1 0 1 6 6 0 6 6 1 0 1 1 0 1 1 1 1 0 6 0 6 1 6 1 0 6 0 6 0
0 1 1 6 1 6 0 1 1 0 0 0 6 0 1 6 0 6 1 0 0 6 0 1 0 0 1 10 6 1 0 1 6 0 6 1 6 10 1 10 10 1 0 6 0 0 1 1 0 1 1 6 1 1 0 1 10 10 1 1 0 1 6 0 1 1 1 0 0 0 6 1 6 6 1 6 6 1 6 0 1 0 1 1 0 0 6 6 0 6 1 0 0 0 0 1 0 0 6 0
1 1 0 6 6 6 0 1 0 6 0 6 6 1 1 6 1 0 0 6 6 1 1 1 0 6 6 10 1 1 1 1 0 1 0 1 1 10 10 10 0 6 1 6 6 0 6 6 1 0 1 6 1 1 1 1 10 1 0 0 6 1 1 0 0 6 0 0 1 6 6 1 6 1 5 1 1 1 6 1 1 6 1 1 1 1 1 6 6 1 1 0 1 0 0 0 1 0 1 6
6 6 0 6 6 0 1 6 0 5 0 6 1 1 0 0 0 1 0 6 0 0 0 0 6 0 0 10 10 6 0 0 1 0 6 1 6 10 6 10 0 6 1 0 1 1 1 0 0 6 1 0 1 6 0 6 10 6 6 1 1 1 1 0 1 1 1 0 1 0 1 0 1 1 1 6 0 0 1 6 0 6 0 0 1 0 0 1 6 6 0 0 1 0 0 1 1 6 0 0
